.bbb....b
......ppp
....bb...
Ebbb....b
pppp...f.
......b..
.BB...BB.
h...p....
..b..bbeb