bb.bb.bbb
pppp..ppp
b.b...b.b
....b....
.........
Ebbe..eeE
BBBBBhBBB
.....ppp.
bbb...bb.


