.bbb..bbb
.....e...
....bBBb.
b.p.....b
b.......b
b...h...b
b...pp..b
.p...bbb.
ebb.ppp..