......bb.
..BBB...b
b...e...b
b...BBB.b
b.E..pppb
bppp...h.
......pp.
bbb......
....BB...